Date,Details,Withdrawals,Deposits,Balance
07/01/2023,Opening Balance,,,"$3,200.00"
07/02/2023,ATM Withdrawal,$200.00,,"$3,000.00"
07/05/2023,Direct Deposit Paycheck,,"$1,500.00","$4,500.00"
07/10/2023,Online Transfer Rent,$800.00,,"$3,700.00"
07/15/2023,Grocery Store,$150.00,,"$3,550.00"
07/20/2023,Bill payment,$100.00,,"$3,450.00"
